20 13 0
00000000000000000000
00001111110000000000
00011000011110000000
00010000000010000000
00010011000010000000
00010011000011000000
00011000000011000000
00011000011001000000
00001000011001000000
00001000000001000000
00001111000011000000
00000001111110000000
00000000000000000000

