20 13 1
00000000111000000000
10101010111010101010
10101010111010101010
10101010000010101010
10101010000010101010
10101000000000101010
00000000000000000000
01010100000001010101
01010100000001010101
01010101000101010101
01010101010101010101
01010101010101010101
00000000000000000000

00000000000000000000
00000000000000000000
00000000000000000000
00000000000000000000
00000000010000000000
00000000111000000000
00000001161100000000
00000000111000000000
00000000010000000000
00000000000000000000
00000000000000000000
00000000000000000000
00000000000000000000