20 13
00000000000000000000
10101010101010101010
10101010101010101010
10101010101010101010
10101010101010101010
10101010101010101010
00000000000000000000
01010101010101010101
01010101010101010101
01010101010101010101
01010101010101010101
01010101010101010101
00000000000000000000