20 13 1
00000000000000000000
00000000000000000000
00000111111111000000
00001111111100000000
00111111111000000000
01111111111000001100
01111111111000001110
01111111111100011110
00011111111111111110
00001111111111111110
00000000011111111000
00000000001111000000
00000000000000000000

00000000000000000000
00000000000000000000
00000000000000000000
00000000000050100000
00000000000400010000
00000000000006000000
00000000000000050000
00000000000000400000
00000000000000000000
00000000000000000000
00000000000000000000
00000000000000000000
00000000000000000000
