20 13 1
00000111111111111111
00000000111111111111
00000000000001111111
00000000000000001111
00000000000000000011
00000000000000000001
00000000000000000001
00000000000000000001
00000000000000000011
00000000000000001111
00000000000001111111
00000000111111111111
00000111111111111111

00000000000000000000
00000000000000000000
00000000000000000000
00000050000000000000
00000000000000000000
00000000010000000000
00000000012000600030
00000000010000000000
00000000000000000000
00000050000000000000
00000000000000000000
00000000000000000000
00000000000000000000
