20 13 1
11000000111100000011
10011100000000111001
00111110000001111100
00111110000001111100
00011100000000111000
11000000000000000011
11000000000000000011
11000000000000000011
00011100000000111000
00111110000001111100
00111110000001111100
10011100000000111001
11000000111100000011

00000000000000000000
00000000000000000000
00000000000000000000
00000000000000000000
00000000000000000000
00000000015100000000
00000005165050000000
00000000015100000000
00000000000000000000
00000000000000000000
00000000000000000000
00000000000000000000
00000000000000000000
