20 13 1
00000000000000000000
01111111111111111110
01000000000000000010
01011111100111111010
01010000000000001010
01010111111111101010
00010000000000001000
01010111111111101010
01010000000000001010
01011111100111111010
01000000000000000010
01111111111111111110
00000000000000000000

00000000000000000000
00000000000000000000
00000000000000000000
00000000000000000000
00000000000000000000
00000000000000000000
00000151565151500000
00000000000000000000
00000000000000000000
00000000000000000000
00000000000000000000
00000000000000000000
00000000000000000000
