20 13 1
00000000000000000000
01111011101111101110
01000000001000000010
01011110101010111010
01000000100000100010
01111011101110101110
00000000001000100000
01111011101011101110
00001010101000001000
01101110101010101010
00001000000010100010
01111011111110111110
00000000000000000000

00000000000000000000
00000100010000010000
00000000000000000000
00000000000000000000
00000002000000000000
00000000000000000000
01000000060500000010
00000000000000000000
01000002000000000010
00000000000000000000
01000000000000000000
00000100000001000000
00000000000000000000
