20 13 1
00000000000000000000
01000000000000000010
01000000000000000010
01000000000000000010
01000000000000000010
01111111000111111110
01111111000111111110
01111111000111111110
01000000000000000010
01000000000000000010
01000000000000000010
01000000000000000010
00000000000000000000

00000000000000000000
00400000000000000400
00000000000000000000
00000000000000000000
00000005111500000000
00000000000000000000
00000000060000000000
00000000000000000000
00000005111500000000
00000000000000000000
00000000000000000000
00400000000000000400
00000000000000000000
